NO ./textures/topBlocks_01.xpm
EA ./textures/block.xpm
WE ./textures/wall.xpm
SO ./textures/midBlocks_01.xpm

F 127,127,127
C 0,100,200

1111
1E1
111
