NO ./textures/topBlocks_01.xpm
EA ./textures/block.xpm
WE ./textures/wall.xpm
SO ./textures/midBlocks_01.xpm
DO ./textures/pics/eagle.png


F 127,127,127
C 127,127,127

        1111111111111111111111111
        100D000000110000000000001
        1011000001110000000000001
        10010000000D0000000000001
111111111011000001110000000000001
10000000001100000111011111D111111
1111D111111111D11100000010001
11110111111111011101010010001
11000000110101011100000010001
10000000000000001100000010001
10000000000000001101010010001
110000011101D1D11111011110N0111
11110111 1110101 101111010001
11111111 1111111 111111111111
