NO ./textures/topBlocks_01.xpm
SO ./textures/midBlocks_01.xpm
WE ./textures/wall.xpm
EA ./textures/block.xpm
F 10,10,10
C 20,20,20
11111
10001
10E01
10001
11111
