NO ./textures/topBlocks_01.xpm
SO ./textures/midBlocks_01.xpm
WE ./textures/wall.xpm
EA ./textures/block.xpm
F 0,128,255
C 255,128,0
  11111
  10001
11110N1
1000001
1111111
