NO ./textures/topBlocks_01.xpm
SO ./textures/midBlocks_01.xpm
WE ./textures/wall.xpm
EA ./textures/block.xpm
F 0,0,0
C 255,255,255
11111
10000
10N01
11111
